00000000000000000000000000000000000000000000000000000000000000000000000000000000000000000000000000000000000000000000000000000000000000000000
00000000000000000000000000000000000000000000000042222222222222222222225000000000000000000000000000000000000000000000000000000000000000000000
00000000000000000000000000000000000000000000000000000000000000000000000000004222500000000000000000000000000000000000000000000000000000000000
00000000000000000000042222225000000000000000000000000000000045000000000000000000000000422222225000000000000000000000000000000000000000000000
00020000422222222500000000000000000000000000000000000000000000000000000000000000000000000000000000000000000000000000022200000000000000000000
00000000000000000000000000000000000000000000000000000000000000000004222222225000000000000000000000042250000000002222211100000000000000000000
42500000000000000000000000042222225000000000000000004222222250000000000000000000000000000450000004211110000000001111111100000000000222200000
31122222222222222222222222211111111000000000000000000000000000000000000000000422222222500000000000000000000000221111111100000000022111100000
31111111111111111111111111111111111222222222222222222222222222222500000200000711111111100000000000000000000222111111111100000022211111100000
31111111111111111111111111111111111111111111111111111111111111111100000322000071111100000000004222222225000111111111111100022211111111100000
31111111111111111111111111111111111111111111111111111111111111111100000311000003111000000000003111111117000000000000000000000000000000000000
311111111111111111111111111111111111111111111111111111111111111111000000000000311100000000000061111100000000000000000000000000000000000000
71111111111111111111111111111111111111111111111111111111111111111600000000000000000000000000000000000000000000000000000000000000000000000000